14, 14, 14, 14, 14, 14, 14, 14, 14, 14, 14, 14, 14, 14, 14, 14, 14, 14, 14, 14, 14, 14, 14, 14, 14, 14, 14, 14, 14, 14, 14, 14, 
14, 16, 18, 20, 00, 00, 14, 14, 00, 00, 00, 00, 00, 00, 00, 14, 00, 00, 00, 14, 14, 14, 14, 14, 14, 00, 00, 00, 00, 00, 00, 14, 
14, 00, 00, 00, 00, 00, 14, 14, 00, 00, 00, 14, 00, 00, 00, 14, 00, 14, 00, 00, 00, 00, 00, 14, 14, 00, 00, 00, 00, 00, 00, 14, 
14, 00, 00, 00, 00, 00, 14, 14, 00, 00, 00, 14, 00, 00, 00, 14, 00, 14, 00, 14, 14, 00, 14, 14, 14, 00, 00, 17, 00, 00, 00, 14, 
14, 00, 00, 00, 00, 00, 14, 14, 00, 00, 00, 14, 00, 00, 00, 14, 00, 14, 00, 14, 00, 00, 14, 14, 14, 00, 00, 00, 00, 00, 00, 14, 
14, 00, 00, 19, 00, 00, 14, 14, 00, 00, 00, 14, 00, 00, 00, 14, 00, 14, 00, 00, 00, 00, 14, 14, 14, 00, 00, 00, 00, 00, 00, 14, 
14, 00, 00, 00, 00, 00, 14, 14, 00, 00, 00, 14, 00, 00, 00, 14, 00, 14, 14, 00, 14, 14, 14, 14, 14, 00, 00, 00, 00, 00, 00, 14, 
14, 00, 00, 00, 00, 00, 14, 14, 00, 14, 00, 14, 00, 00, 00, 14, 00, 14, 00, 00, 00, 14, 14, 14, 14, 00, 00, 00, 00, 00, 00, 14, 
14, 00, 00, 00, 00, 00, 14, 14, 00, 00, 00, 14, 00, 00, 00, 14, 00, 14, 00, 14, 00, 14, 14, 14, 14, 00, 00, 00, 00, 00, 00, 14, 
14, 00, 00, 00, 00, 00, 14, 14, 14, 00, 14, 14, 00, 00, 00, 14, 00, 14, 00, 00, 00, 14, 14, 14, 14, 00, 00, 00, 00, 00, 00, 14, 
14, 00, 00, 00, 00, 00, 14, 14, 00, 00, 00, 14, 00, 00, 00, 14, 00, 14, 14, 00, 14, 14, 14, 14, 14, 00, 00, 00, 00, 00, 00, 14, 
14, 00, 00, 00, 00, 00, 14, 14, 00, 00, 00, 14, 00, 00, 00, 14, 00, 14, 00, 00, 00, 14, 14, 14, 14, 00, 00, 00, 00, 00, 00, 14, 
14, 00, 00, 00, 00, 00, 14, 14, 00, 00, 00, 14, 00, 00, 00, 14, 00, 14, 00, 00, 00, 14, 14, 14, 14, 00, 00, 00, 00, 00, 00, 14, 
14, 00, 00, 00, 00, 00, 00, 00, 00, 00, 00, 14, 00, 00, 00, 00, 00, 14, 00, 00, 00, 00, 00, 00, 00, 00, 00, 00, 00, 00, 00, 14, 
14, 14, 14, 14, 14, 14, 14, 14, 14, 14, 14, 14, 14, 14, 14, 14, 14, 14, 14, 14, 14, 14, 14, 14, 14, 14, 14, 14, 14, 14, 14, 14,end,
RULES:cat-player,lock-lock,clock-stop,flag-goal,platform-move,cactus-spiky,