14, 14, 14, 14, 14, 14, 14, 14, 14, 14, 14, 14, 14, 14, 14, 14, 14, 14, 14, 14, 14, 14, 14, 14, 14, 14, 14, 14, 14, 14, 14, 14, 
14, 0, 0, 0, 0, 0, 14, 14, 0, 0, 0, 0, 0, 0, 0, 14, 0, 0, 0, 14, 14, 14, 14, 14, 14, 0, 0, 0, 0, 0, 0, 14, 
14, 0, 0, 0, 0, 0, 14, 14, 0, 0, 0, 14, 0, 0, 0, 14, 0, 14, 0, 0, 0, 0, 0, 14, 14, 0, 0, 0, 0, 0, 0, 14, 
14, 0, 0, 0, 0, 0, 14, 14, 0, 0, 0, 14, 0, 0, 0, 14, 0, 14, 0, 14, 14, 0, 14, 14, 14, 0, 0, 17, 0, 0, 0, 14, 
14, 0, 0, 0, 0, 0, 14, 14, 0, 0, 0, 14, 0, 0, 0, 14, 0, 14, 0, 14, 0, 0, 14, 14, 14, 0, 0, 0, 0, 0, 0, 14, 
14, 0, 0, 19, 0, 0, 14, 14, 0, 0, 0, 14, 0, 0, 0, 14, 0, 14, 0, 0, 0, 0, 14, 14, 14, 0, 0, 0, 0, 0, 0, 14, 
14, 0, 0, 0, 0, 0, 14, 14, 0, 0, 0, 14, 0, 0, 0, 14, 0, 14, 14, 0, 14, 14, 14, 14, 14, 0, 0, 0, 0, 0, 0, 14, 
14, 0, 0, 0, 0, 0, 14, 14, 0, 14, 0, 14, 0, 0, 0, 14, 0, 14, 0, 0, 0, 14, 14, 14, 14, 0, 0, 0, 0, 0, 0, 14, 
14, 0, 0, 0, 0, 0, 14, 14, 0, 0, 0, 14, 0, 0, 0, 14, 0, 14, 0, 14, 0, 14, 14, 14, 14, 0, 0, 0, 0, 0, 0, 14, 
14, 0, 0, 0, 0, 0, 14, 14, 14, 0, 14, 14, 0, 0, 0, 14, 0, 14, 0, 0, 0, 14, 14, 14, 14, 0, 0, 0, 0, 0, 0, 14, 
14, 0, 0, 0, 0, 0, 14, 14, 0, 0, 0, 14, 0, 0, 0, 14, 0, 14, 14, 0, 14, 14, 14, 14, 14, 0, 0, 0, 0, 0, 0, 14, 
14, 0, 0, 0, 0, 0, 14, 14, 0, 0, 0, 14, 0, 0, 0, 14, 0, 14, 0, 0, 0, 14, 14, 14, 14, 0, 0, 0, 0, 0, 0, 14, 
14, 0, 0, 0, 0, 0, 14, 14, 0, 0, 0, 14, 0, 0, 0, 14, 0, 14, 0, 0, 0, 14, 14, 14, 14, 0, 0, 0, 0, 0, 0, 14, 
14, 0, 0, 0, 0, 0, 0, 0, 0, 0, 0, 14, 0, 0, 0, 0, 0, 14, 0, 0, 0, 0, 0, 0, 0, 0, 0, 0, 0, 0, 0, 14, 
14, 14, 14, 14, 14, 14, 14, 14, 14, 14, 14, 14, 14, 14, 14, 14, 14, 14, 14, 14, 14, 14, 14, 14, 14, 14, 14, 14, 14, 14, 14, 14,end,
RULES:cat-player,lock-lock,clock-stop,flag-goal,platform-move,cactus-spiky,